colour->color
colours->colors
coloured->colored
colouring->coloring
flavour->flavor
flavours->flavors
flavoured->flavored
honour->honor
honours->honors
honoured->honored
honouring->honoring
behaviour->behavior
behaviours->behaviors
behavioural->behavioral
neighbour->neighbor
neighbours->neighbors
labour->labor
labours->labors
favourite->favorite
favourites->favorites
rumour->rumor
rumours->rumors
humour->humor
humours->humors
vigour->vigor
centre->center
centres->centers
centred->centered
centring->centering
metre->meter
metres->meters
litre->liter
litres->liters
theatre->theater
theatres->theaters
fibre->fiber
fibres->fibers
calibre->caliber
calibres->calibers
organise->organize
organises->organizes
organised->organized
organising->organizing
organisation->organization
organisations->organizations
organisational->organizational
realise->realize
realises->realizes
realised->realized
realising->realizing
realisation->realization
recognise->recognize
recognises->recognizes
recognised->recognized
recognising->recognizing
analyse->analyze
analyses->analyzes
analysed->analyzed
analysing->analyzing
paralyse->paralyze
paralyses->paralyzes
paralysed->paralyzed
paralysing->paralyzing
optimise->optimize
optimises->optimizes
optimised->optimized
optimising->optimizing
optimisation->optimization
summarise->summarize
summarises->summarizes
summarised->summarized
summarising->summarizing
minimise->minimize
minimises->minimizes
minimised->minimized
minimising->minimizing
minimisation->minimization
maximise->maximize
maximises->maximizes
maximised->maximized
maximising->maximizing
maximisation->maximization
standardise->standardize
standardises->standardizes
standardised->standardized
standardising->standardizing
standardisation->standardization
normalise->normalize
normalises->normalizes
normalised->normalized
normalising->normalizing
normalisation->normalization
visualise->visualize
visualises->visualizes
visualised->visualized
visualising->visualizing
visualisation->visualization
specialise->specialize
specialises->specializes
specialised->specialized
specialising->specializing
specialisation->specialization
catalogue->catalog
catalogues->catalogs
catalogued->cataloged
cataloguing->cataloging
dialogue->dialog
dialogues->dialogs
licence->license
licences->licenses
defence->defense
defences->defenses
offence->offense
offences->offenses
pretence->pretense
pretences->pretenses
grey->gray
greys->grays
programme->program
programmes->programs
sceptic->skeptic
sceptics->skeptics
sceptical->skeptical
scepticism->skepticism
sulphur->sulfur
aluminium->aluminum
draught->draft
draughts->drafts
plough->plow
ploughs->plows
ploughed->plowed
ploughing->plowing
tyre->tire
tyres->tires
mould->mold
moulds->molds
moulded->molded
moulding->molding
